F 15,6,40
C 35,19,73

111111111111111
111111000000011
111110000000011
1111000N0000011
111000000000111
110000000000011
100001111100001
110000111000011
111000010000111
111100000001111
111110000011111
111111000111111
111111111111111