NO ./texture/north.png
SO ./texture/south.png
WE ./texture/west.png
EA ./texture/east.png

C 10,10,250
F 90,90,255

111111111111111111111111111111111
100000000100000000010000000000001
101100000001000000000000000100001
100000000100000100000000100001001
1111111110110N0001010000000000001
100000000011000001010101110101001
111100000000011011100000010000001
111101111111110111010100000010001
110000001101010111000000100000101
100000000000000011000000100010001
100000000000000011010100100000101
110000011101010111110111100100001
111101111110101001011110100000101
111111111111111111111111111111111
