NO /home/marouane/Desktop/marouanCub3d/texture/north.png
SO /home/marouane/Desktop/marouanCub3d/texture/south.png
WE /home/marouane/Desktop/marouanCub3d/texture/west.png
EA /home/marouane/Desktop/marouanCub3d/texture/east.png

C 35,19,73
F 15,6,40

1111111111111111111111111
1000000000000000000000001
1011000000000000001000001
1001000000100000000100001
1111111110110100001000001
1000110000110010010001001
1111011111111101111000001
1111011111111101110100001
1100000011010101110010001
1000000000000000100010001
1000000000000101010010001
1100000101111101111010111
11110111111010011110100N1
1111111111111111111111111