F 164,169,20
C 153,204,255

1111111111111111111111111
        1000000000000000000000001
        1011000000000000001000001
        1001000000100000000100001
111111111011010000000000001000001
100011000011001001000111111111111
11110111111111011110000000001
11110111111111011101010010001
11000000110101011100000010001
10000000000000001100000010001
10000000000000001101010010001
1100000111010101111101111010111
11110111 1110101 1011110100N1
11111111 1111111 111111111111