NO /home/marouane/Desktop/marouanCub3d/texture/north.png
SO /home/marouane/Desktop/marouanCub3d/texture/south.png
WE /home/marouane/Desktop/marouanCub3d/texture/west.png
EA /home/marouane/Desktop/marouanCub3d/texture/east.png

C 35,19,73
F 15,6,40

1111111111111111111
10E1001001001000001
1011000001000001001
1001001001111101111
1001111000001001001
1000000000000001001
1001111111111001001
1111000000000001011
1000000001000000001
1111111111111111111